{
  "level": [
    {
      "levelID": 1,
      "levelArray": [
        "###########",
        "#    |    U",
        "### ### # #",
        "#   # # #-#",
        "# ### # # #",
        "# U   #-# #",
        "# ### # # #",
        "#   D   #-#",
        "# # ##### #",
        "#s#  |  #f#",
        "###########"

      ]
    },
    {
      "levelID": 2,
      "levelArray": [
        "###################################D#####",
        "# #  f#     #     #         #     #   # #",
        "# # ### # # # ### ######### # ### # # # #",
        "#       # # # #   #       # #   # # # # #",
        "### ##### # ### ### ##### # ### # # # # #",
        "# # #     #   #   # #     #   # # # #   #",
        "# # # ####### # ### ######### # # # #u# #",
        "#   # #   #   #     #     #     #   # # #",
        "##### # ### ### # # # ### # ### ##### # #",
        "#     #   #   # # #   #   #   #     # # #",
        "# ####### # ### ####### ##### ##### # # #",
        "# #       #   # #     #     #   # #   # #",
        "# # # ####### ### ### ##### ### # ##### #",
        "# # #     #   #     #     #     # #     #",
        "# ##### # # ### ### # ########### # #####",
        "# #   # # #   # #   #       #   # # #   #",
        "# # # ### # ### # ##### ### # # # # # ###",
        "# # #     #     # #     #   # #   # #   #",
        "# # ############# ### ##### # ##### ### #",
        "#   #   #   #   #   # #     # #     #   #",
        "### # # # # # ### # ### ##### # ### # ###",
        "#   # #   # #     # #         # #   # # #",
        "# ######### ####### # ######### # ### # #",
        "#   #     # #     # #         # # #   # #",
        "### # ### # # ### # # ####### # # # ### #",
        "#     #   #   # #   #   #     # # #   # #",
        "# ##### ####### ####### # ##### # # # # #",
        "# #   # #   #           #   #   # # #   #",
        "# ### # # # # ############# ##### # #####",
        "#   #   # # #     #         #     # #   #",
        "### ##### ####### # ######### ##### # # #",
        "# #   #   #       #       #   #   #   # #",
        "# ##### # # ####### ##### # ### # # ### #",
        "#       # #   #   #   # #       #   #   #",
        "# ### ####### # # #D# # ############# ###",
        "# # # D       # #   # #     U   #   #   #",
        "# # # # ####### ### # ##### # # # ##### #",
        "# #   #         #   # #   #   # # #     #",
        "# #####U########### # # # # ### # # #####",
        "#              s    #   #   #   #       #",
        "#########################################"
      ]
    },
    {
      "levelId": 3,
      "levelArray": [
        "###########################################################",
        "# #          f                                            #",
        "# # ##################################################### #",
        "# # #                                           # #     # #",
        "# # ############################### ########### # ### # # #",
        "# #                   # # #       # # #     # # #     # # #",
        "# # ################### # ####### # # # ### # # # # # # # #",
        "# # #                 #   #           # # #     # # # # # #",
        "# # ################# # # ########### # # # ##### ### # # #",
        "#   #                 # #             # # #     #   # # # #",
        "### ################# # ############# # # ### ##### ### # #",
        "# #     #             #             # # # # #     # #   # #",
        "# # ################# ############# # # # # ##### # # # # #",
        "# #                   #           # # # # #       # # # # #",
        "# ################### # ######### ##### # ####### # # # # #",
        "#                   # # #       # # # # #       # # # # # #",
        "# ################# # # # # ### # # # # # # ### # # ### # #",
        "#                 # # # # # #   # # # # # # #   # # # # # #",
        "################# # # # # # ##### # # # # # ##### # # # # #",
        "#                 # # # # #           # # #   #     #   # #",
        "# ############### # # # # ####### ##### # # ######### # # #",
        "# #       #     # # #   #   #           # #   #       # # #",
        "# # ### ####### # # # # ################# ########### # # #",
        "# # # #   #   # # #   #       #                     # # # #",
        "# # # # # ### # # # # # ##### # ##### ############### # # #",
        "# # # # # #   # # # # # #   #   #   # #             # # # #",
        "# ### # # ### # # # # # # ### ### ### ########### # # # # #",
        "# # # # #       # # # # # #         #             # # # # #",
        "# # # # ######### # # # # # ####################### # # # #",
        "#   # #           # # # #   #   #                 # # # # #",
        "# # # ### ######### # # # ### # ############# ##### # # # #",
        "# # #     #         # # #   # #                 # # # # # #",
        "# # ################# # ### # # ############### # # # # # #",
        "# #           #       # #   # # # #           # # # # # # #",
        "# ##################### ### # # # # # # ##### # # # # # # #",
        "# #                     # # # # # # # # #       # # # # # #",
        "# # ##################### # # # # # # # # ### ### # # # # #",
        "# # #                       # # # # # # # # # # # # # # # #",
        "# # # ####### ############# # # # # # # # # # # # ### # # #",
        "# # # #     # #         # # # # # # # # # #     # # # # # #",
        "# ### ##### # ######### # # # # # # # # # ####### # # # # #",
        "# # #     # # # # #       # # # # # # # #         # # # # #",
        "# # # ### # ### # ### # # # # # # # # # ########### # # # #",
        "# # # # # # # # # #   # # # # # # # # #       #     # # # #",
        "### # # # # # # # # # ### # # # # # # ############# # # # #",
        "# # # #   # # # # # #   #   # # # # #               # # # #",
        "# # # ##### # # # # # ### # # # # # ############### # # # #",
        "# # #       # # #   #   # # # # # #             # # # # # #",
        "# # ####### # # # # ####### # # # # ############# # # # # #",
        "# #           # # #     #   # # #           #     # # # # #",
        "# # ########### ########### # # ################# # # # # #",
        "# #             #           # #                 # # # # # #",
        "# ########################### ################### # # # # #",
        "#                                                 # # # # #",
        "# ######################################### ######### # # #",
        "# #                                                   # # #",
        "####### ############# ################################# # #",
        "#                s  #               #                   # #",
        "###########################################################"]
    }
  ]
}